Assamese::Iscii	data/enc-lang-identifier/training/Assamese-Iscii
Assamese::UTF8	data/enc-lang-identifier/training/Assamese-UTF8
Bengali::Iscii	data/enc-lang-identifier/training/Bengali-Iscii
Bengali::UTF8	data/enc-lang-identifier/training/Bengali-UTF8
Czech::Windows-1250	data/enc-lang-identifier/training/Czech-Windows-1250
Danish::ISO-8859-1	data/enc-lang-identifier/training/Danish-ISO-8859-1
English::Ascii	data/enc-lang-identifier/training/English-Ascii
Finnish::ISO-8859-1	data/enc-lang-identifier/training/Finnish-ISO-8859-1
French::ISO-8859-1	data/enc-lang-identifier/training/French-ISO-8859-1
German::ISO-8859-1	data/enc-lang-identifier/training/German-ISO-8859-1
Hindi::Iscii	data/enc-lang-identifier/training/Hindi-Iscii
Hindi::Isfocb	data/enc-lang-identifier/training/Hindi-Isfocb
Hindi::ITrans	data/enc-lang-identifier/training/Hindi-ITrans
#Hindi::NaiDunia	data/enc-lang-identifier/training/Hindi-NaiDunia
Hindi::Phonetic-Shusha	data/enc-lang-identifier/training/Hindi-Phonetic-Shusha
Hindi::Typewriter	data/enc-lang-identifier/training/Hindi-Typewriter

Hindi::UTF8	data/enc-lang-identifier/training/Hindi-UTF8
Hindi::Webdunia	data/enc-lang-identifier/training/Hindi-Webdunia
Hindi::WX	data/enc-lang-identifier/training/Hindi-WX
Italian::ISO-8859-1	data/enc-lang-identifier/training/Italian-ISO-8859-1
Icelandic::UTF8	data/enc-lang-identifier/training/Icelandic-UTF8
Kannada::Iscii	data/enc-lang-identifier/training/Kannada-Iscii
Kannada::UTF8	data/enc-lang-identifier/training/Kannada-UTF8
Malayalam::Iscii	data/enc-lang-identifier/training/Malayalam-Iscii
Malayalam::UTF8	data/enc-lang-identifier/training/Malayalam-UTF8
Marathi::Iscii	data/enc-lang-identifier/training/Marathi-Iscii
Marathi::UTF8	data/enc-lang-identifier/training/Marathi-UTF8
Oriya::Iscii	data/enc-lang-identifier/training/Oriya-Iscii
Oriya::UTF8	data/enc-lang-identifier/training/Oriya-UTF8
Punjabi::Iscii	data/enc-lang-identifier/training/Punjabi-Iscii
Punjabi::UTF8	data/enc-lang-identifier/training/Punjabi-UTF8
Spanish::ISO-8859-1	data/enc-lang-identifier/training/Spanish-ISO-8859-1
Tamil::Iscii	data/enc-lang-identifier/training/Tamil-Iscii
Tamil::UTF8	data/enc-lang-identifier/training/Tamil-UTF8
Telugu::Iscii	data/enc-lang-identifier/training/Telugu-Iscii
Telugu::UTF8	data/enc-lang-identifier/training/Telugu-UTF8

Afrikaans::ISO-8859-1	data/enc-lang-identifier/training/Afrikaans-ISO-8859-1
Bulgarian::Windows-1251	data/enc-lang-identifier/training/Bulgarian-Windows-1251
Catalan::ISO-8859-1	data/enc-lang-identifier/training/Catalan-ISO-8859-1
Esperanto::UTF8	data/enc-lang-identifier/training/Esperanto-UTF8
#Greek::UTF8	data/enc-lang-identifier/training/Greek-UTF8
ModernGreek::UTF8	data/enc-lang-identifier/training/ModernGreek-UTF8
Gujarati::Gopika	data/enc-lang-identifier/training/Gujarat-Gopika
Gujarati::Govinda	data/enc-lang-identifier/training/Gujarati-Govinda
#Gujarati::Sandn	data/enc-lang-identifier/training/Gujarati-Sandn
Hebrew::UTF8	data/enc-lang-identifier/training/Hebrew-UTF8
Iroquoian::ISO-8859-1	data/enc-lang-identifier/training/Iroquoian-ISO-8859-1
Khasi::US-ASCII	data/enc-lang-identifier/training/Khasi-US-ASCII
Latin::ISO-8859-1	data/enc-lang-identifier/training/Latin-ISO-8859-1
Iloko::ISO-8859-1	data/enc-lang-identifier/training/Iloko-ISO-8859-1
Marathi::Manjusha	data/enc-lang-identifier/training/Marathi-Manjusha
Marathi::Saamanaa	data/enc-lang-identifier/training/Marathi-Saamanaa
Marathi::Subak	data/enc-lang-identifier/training/Marathi-Subak
Nahuatl::ISO-8859-1	data/enc-lang-identifier/training/Nahuatl-ISO-8859-1
Norwegian::ISO-8859-1	data/enc-lang-identifier/training/Norwegian-ISO-8859-1
Oriya::AkrutiSarala	data/enc-lang-identifier/training/Oriya-AkrutiSarala
Polish::ISO-8859-2	data/enc-lang-identifier/training/Polish-ISO-8859-2
Portugues::ISO-8859-1	data/enc-lang-identifier/training/Portugues-ISO-8859-1
Romanian::US-ASCII	data/enc-lang-identifier/training/Romanian-US-ASCII
Russian::Windows-1251	data/enc-lang-identifier/training/Russian-Windows-1251
Serbian::UTF8	data/enc-lang-identifier/training/Serbian-UTF8
Tagalog::ISO-8859-1	data/enc-lang-identifier/training/Tagalog-ISO-8859-1
Welsh::US-ASCII	data/enc-lang-identifier/training/Welsh-US-ASCII
Dutch::ISO-8859-1	data/enc-lang-identifier/training/Dutch-ISO-8859-1
